2 13 31
###############################
#p * *2       *  ** * *      *#
# # # # #*# # #*# # # # # #*# #
#    * * *** **      *    **  #
# #*# # # # #1# #b#1# # # # #*#
#          *     *x*      *  *#
# # #*# # # # # #*#*#*#*# # # #
#   *        *   * *  * *   2 #
# # # # #*# # # # # # #*# #*# #
#   ****         *4           #
# # # # # # # # # #*# # # # #*#
#  ** *   *    3              #
###############################