2 13 31
###############################
#p * *2       *  ** * *      *#
# # # # #*# # #*# # # # # #*# #
#    * * f * **      *    **  #
# #*# # # # #1# #b#1# # # # #*#
#          *     *x*      *  *#
#s# #*# # # # # #*#*#*#*# # # #
#   *    f   *   * *  * *   2 #
# # # # #*# # # # # # #*# #*# #
#   ** *         *4           #
# # # # # # # # # #*# # # # #*#
#  *b *   *    3              #
###############################