5 13 31
###############################
#   3   ** *   * 5*  * * *    #
# # # #*# # #*#*# # # #*#*#*# #
#     *      ***  *  2 *  * * #
# s # # # #*# # #*#*# # # # #*#
#     b  p   **  *  *       *x#
# # # # # # # # # #*# #*# # # #
#*  *       *  *  4   *s      #
# #   # #*# # # #*#*# # # # # #
#* 1    **  *       *   *     #
# #*# # # # # # #*# # # # # # #
#     3     *   *  *  f     5 #
###############################