3 13 31
###############################
#p   s* **    *   2      *    #
# f # #*# # # # x # # # # # # #
#*     ** * *  *   * **   *   #
# # # # # #*# # # # # # #*# # #
#*   * *2      * *x **    4   #
# # # # # # #*# # # # # # #*# #
#    *     *        * 3  **   #
# #*# # #*#*#b#*# # # # # #*# #
#     5   *   * *    *   *    #
#*# # # # # # # # # # #*# # #*#
# *    * **    ** *** s   1   #
###############################