4 13 31
###############################
#p * *    4   *  ** * *      *#
# # # # #*# # #*# # # # # #*# #
#    * * * * **  5   *    **  #
# #*# # # # #2# #b#1# # # # #*#
#          *     **      *  **#
# # #*# # # # # #*# #*#*# # # #
#   *    1   *     *x* *   3  #
# # # # #*# # # # # # #*# #*# #
#   *  *         *4           #
# # # # # # # # # #*# # # # #*#
#  ** *5  *    2   *   *      #
###############################